B_CODE,FL_ZONE,Other,Flood,Roof,Sandy,Panat,Mitigation,Tot
A1,0,0,10,0,0,0,0,10
A2,0,10,0,0,0,0,0,10
A3,0,5,5,5,5,5,5,30
A4,0,3,0,0,0,2,0,5
A5,0,1,6,6,9,3,2,27
A6,0,0,3,0,3,1,0,7
A7,1,0,0,0,0,0,0,0
A8,1,1,4,7,0,3,1,16
A9,1,4,6,5,8,4,4,31
A10,1,2,0,0,0,0,4,6
A11,1,0,0,4,7,8,0,19
